....................
....................
......#########.....
..............#.....
..............#.....
..............#.....
..............###...
....................
....................
....................
....................
....................
....................
....................
....................