....................
....................
....................
..........######....
...............#....
....................
....................
....................
..######............
......#.............
......#.....##......
......#.....#.......
....................
....................
....................